S..G.WW...WWWWW
.....WWWWWWWWWW
WW.............
....WWWWWWWWWWW
WW............W
WWWWWWWWWWWW...
WWWWW.........W
.......WWWW....
WW..WW.WWW..WWW
WW.............
WWWW...........
WWWWWW........
WWWWW..........
.WW...W...WWWWW
WW....W........
WW........WW...