S....WWWWWWWWWW
.....WWWWWWWWWW
WW.............
....WWWWWWWWWWW
WW............W
WWWWWWWWWWWW...
WWWWW.........W
WWW....WWWW....
WW..WW.WWW..WWW
WW.........WWWW
WWWW......WWWWW
WWWWWW........W
WWWWW..........
WWW...W...WW..W
WWWWWWW...WW..G