S.......WWWWWWW
WW..WWW...WWWWW
WW.....WW....WW
....WWWWWWWW.WW
WW.....WW.....W
WW.WWWWWWWWW.WW
WW.WW.........W
WW.W...WWWW..WW
WW.WWW.WWW...WW
W.......W..W.WW
W.WW....WW...WW
W.WWWW...WWW.WW
W.WWW......W...
W.W...W.WWWW..W
W...WWW...WW..G