S....WWWWWWWWWW
WW.WWWWWWWWWWWW
WW.....WWW.....
....WWWWWWWW.WW
WW............W
WW.WWWWWWWWW...
WW.WW.........W
WW.W...WWWW..WW
WW.WWW.WWW...WW
W..........W.WW
W.WW...WWW...WW
W.WWWW...WWW.WW
W.WWW..........
W.W...W.WWWW..W
W...WWW...WW..G